中国科学技术大学	www.ustc.edu.cn
安徽医科大学	www.ahmu.edu.cn
安徽建筑大学	www.ahjzu.edu.cn
安徽开放大学	www.ahou.edu.cn
安徽信息工程学院	www.aiit.edu.cn
合肥工业大学	www.hfut.edu.cn
安徽农业大学	www.ahau.edu.cn
安徽财经大学	www.aufe.edu.cn
安徽理工大学	www.aust.edu.cn
安徽师范大学	www.ahnu.edu.cn
安徽工程大学	www.ahpu.edu.cn
皖江工学院	www.wjut.edu.cn
安徽大学	www.ahu.edu.cn
安徽中医药大学	www.ahtcm.edu.cn
淮北师范大学	www.chnu.edu.cn
淮南联合大学	www.hnuu.edu.cn
安徽工业大学	www.ahut.edu.cn
安徽科技学院	www.ahstu.edu.cn
蚌埠医学院	www.bbmc.edu.cn
阜阳师范大学	www.fynu.edu.cn
安庆师范大学	www.aqnu.edu.cn
黄山学院	www.hsu.edu.cn
皖南医学院	www.wnmc.edu.cn
安徽新华学院	www.axhu.edu.cn
安徽行政学院(安徽经济管理学院)	www.ahsa.edu.cn
合肥师范学院	www.hfnu.edu.cn
宿州学院	www.ahszu.edu.cn
淮南师范学院	www.hnnu.edu.cn
铜陵学院	www.tlu.edu.cn
安徽三联学院	www.slu.edu.cn
安徽审计职业学院	www.ahsjxy.edu.cn
安徽国防科技职业学院	www.acdt.edu.cn
合肥学院	www.hfuu.edu.cn
滁州学院	www.chzu.edu.cn
滁州技师学院	www.cztc.edu.cn
蚌埠学院	www.bbc.edu.cn
皖西学院	www.wxc.edu.cn
池州学院	www.czu.edu.cn
巢湖学院	www.chu.edu.cn
安徽工商职业学院	www.ahbvc.edu.cn
万博科技职业学院	www.wbc.edu.cn
六安职业技术学院	www.lvtc.edu.cn
马鞍山职业技术学院	www.mastc.edu.cn
亳州学院	www.bzuu.edu.cn
阜阳职业技术学院	www.fyvtc.edu.cn
淮北职业技术学院	www.hbtc.edu.cn
安徽电子信息职业技术学院	www.ahdy.edu.cn
安徽职业技术学院	www.uta.edu.cn
宣城职业技术学院	www.xcvtc.edu.cn
合肥职业技术学院	www.htc.edu.cn
安徽水利水电职业技术学院	www.ahsdxy.edu.cn
合肥幼儿师范高等专科学校	www.hfpec.edu.cn
安徽机电职业技术学院	www.ahcme.edu.cn
安徽商贸职业技术学院	www.abc.edu.cn
滁州职业技术学院	www.chzc.edu.cn
安庆职业技术学院	www.aqvtc.edu.cn
芜湖职业技术学院	www.whit.edu.cn
安徽粮食工程职业学院	www.ahly.edu.cn
安徽城市管理职业学院	www.cua.edu.cn
安徽财贸职业学院	www.afc.edu.cn
安徽中医药高等专科学校	www.ahzyygz.edu.cn
马鞍山师范高等专科学校	www.massz.edu.cn
桐城师范高等专科学校	www.tctc.edu.cn
安徽国际商务职业学院	www.ahiib.edu.cn
安徽警官职业学院	www.ahjgxy.edu.cn
徽商职业学院	www.hsxy.edu.cn
黄山职业技术学院	www.hszy.edu.cn
安徽冶金科技职业学院	www.avcmt.edu.cn
安徽外国语学院	www.aisu.edu.cn
池州职业技术学院	www.czvtc.edu.cn
皖西卫生职业学院	www.wahvc.edu.cn
滁州城市职业学院	www.czcvc.edu.cn
安徽工业经济职业技术学院	www.ahiec.edu.cn
安徽交通职业技术学院	www.acvtc.edu.cn
清华大学合肥公共安全研究院	www.tsinghua-hf.edu.cn
铜陵职业技术学院	www.tlpt.edu.cn
阜阳幼儿师范高等专科学校	www.fypec.edu.cn
合肥城市学院	www.cuhf.edu.cn
安徽新闻出版职业技术学院	www.ahcbxy.edu.cn
安徽广播影视职业技术学院	www.amtc.edu.cn
亳州职业技术学院	www.bzy.edu.cn
马鞍山学院	www.masu.edu.cn
安徽中澳科技职业学院	www.acac.edu.cn
安徽文达信息工程学院	www.wenda.edu.cn
安徽公安职业学院	www.ahpc.edu.cn
安徽医学高等专科学校	www.ahyz.edu.cn
安徽艺术学院	www.ahua.edu.cn
宿州职业技术学院	www.szzy.edu.cn
阜阳科技职业学院	www.fky.net.cn
皖北卫生职业学院	www.wbws.edu.cn
安徽大学江淮学院	www.ahujhc.cn
安徽电气工程职业技术学院	www.aepu.com.cn
安徽工贸职业技术学院	www.ahgmedu.cn
安徽工业职业技术学院	www.ahip.cn
安徽黄梅戏艺术职业学院	www.hmxxy.com
安徽矿业职业技术学院	www.anhky.com
安徽林业职业技术学院	www.ahlyxy.edu.cn
安徽绿海商务职业学院	www.lhub.cn
合肥经济学院	www.hfue.edu.cn
安徽汽车职业技术学院	www.jacedu.cn
安徽涉外经济职业学院	www.ahaec-edu.cn
安徽师范大学皖江学院	wjcollege.ahnu.edu.cn
安徽体育运动职业技术学院	www.ahty.edu.cn
安徽卫生健康职业学院	www.ahwsjkxy.edu.cn
安徽现代信息工程职业学院	www.ahmodern.cn
安徽扬子职业技术学院	www.yangzixueyuan.com
安徽医科大学临床医学院	cc.ahmu.edu.cn
安徽艺术职业学院	www.artah.cn
安徽邮电职业技术学院	www.ahptc.cn
蚌埠经济技术职业学院	www.bjy.ah.cn
合肥共达职业技术学院	www.hfgdxy.cn
合肥科技职业学院	www.hfstu.cn
合肥通用职业技术学院	www.hftyxy.com
合肥信息技术职业学院	hfitu.cn
合肥职工科技大学	www.hfzkd.cn
淮北理工学院	www.hblgxy.edu.cn
淮南职业技术学院	www.hnvtc.cn
蚌埠工商学院	www.bctb.edu.cn
阜阳师范大学信息工程学院	cie.fynu.edu.cn
民办合肥经济技术职业学院	www.hfet.com
民办合肥滨湖职业技术学院	www.hfbhxy.com
民办合肥财经职业学院	www.hfcfe.edu.cn
安庆医药高等专科学校	www.aqmc.edu.cn
黄山健康职业学院	www.hsvch.cn
