北京交通大学	www.njtu.edu.cn
北京工业大学	www.bjut.edu.cn
北京科技大学	www.ustb.edu.cn
北京化工大学	www.buct.edu.cn
北京邮电大学	www.bupt.edu.cn
北京林业大学	www.bjfu.edu.cn
北京协和医学院	www.pumc.edu.cn
北京中医药大学	www.bucm.edu.cn
首都师范大学	www.cnu.edu.cn
北京外国语大学	www.bfsu.edu.cn
中国传媒大学	www.cuc.edu.cn
中央财经大学	www.cufe.edu.cn
对外经济贸易大学	www.uibe.edu.cn
外交学院	www.cfau.edu.cn
中国人民公安大学	www.ppsuc.edu.cn
北京体育大学	www.bsu.edu.cn
中央音乐学院	www.ccom.edu.cn
中国音乐学院	www.ccmusic.edu.cn
中央美术学院	www.cafa.edu.cn
中央戏剧学院	www.chntheatre.edu.cn
中国政法大学	www.cupl.edu.cn
天津工业大学	www.tjpu.edu.cn
天津医科大学	www.tijmu.edu.cn
天津中医药大学	www.tjutcm.edu.cn
华北电力大学	www.ncepu.edu.cn
河北工业大学	www.hebut.edu.cn
太原理工大学	www.tyut.edu.cn
内蒙古大学	www.imu.edu.cn
辽宁大学	www.lnu.edu.cn
大连海事大学	www.dlmu.edu.cn
延边大学	www.ybu.edu.cn
东北师范大学	www.nenu.edu.cn
哈尔滨工程大学	www.hrbeu.edu.cn
东北农业大学	www.neau.edu.cn
东北林业大学	www.nefu.edu.cn
华东理工大学	www.ecust.edu.cn
东华大学	www.dhu.edu.cn
上海海洋大学	www.shou.edu.cn
上海中医药大学	www.shutcm.edu.cn
上海外国语大学	www.shisu.edu.cn
上海财经大学	www.shufe.edu.cn
上海体育学院	www.sus.edu.cn
上海音乐学院	www.shcmusic.edu.cn
上海大学	www.shu.edu.cn
苏州大学	www.suda.edu.cn
南京航空航天大学	www.nuaa.edu.cn
南京理工大学	www.njust.edu.cn
中国矿业大学	www.cumt.edu.cn
南京邮电大学	www.njupt.edu.cn
河海大学	www.hhu.edu.cn
江南大学	www.jiangnan.edu.cn
南京林业大学	www.njfu.edu.cn
南京信息工程大学	www.nuist.edu.cn
南京农业大学	www.njau.edu.cn
南京中医药大学	www.njucm.edu.cn
中国药科大学	www.cpu.edu.cn
南京师范大学	www.njnu.edu.cn
中国美术学院	www.caa.edu.cn
安徽大学	www.ahu.edu.cn
合肥工业大学	www.hfut.edu.cn
福州大学	www.fzu.edu.cn
南昌大学	www.ncu.edu.cn
河南大学	www.henu.edu.cn
中国地质大学	www.cug.edu.cn
武汉理工大学	www.whut.edu.cn
华中农业大学	www.hzau.edu.cn
华中师范大学	www.ccnu.edu.cn
中南财经政法大学	www.zuel.edu.cn
湖南师范大学	www.hunnu.edu.cn
暨南大学	www.jnu.edu.cn
广州中医药大学	www.gzucm.edu.cn
华南师范大学	www.scnu.edu.cn
海南大学	www.hainanu.edu.cn
广西大学	www.gxu.edu.cn
西南交通大学	www.swjtu.edu.cn
西南石油大学	www.swpu.edu.cn
成都理工大学	www.cdut.edu.cn
四川农业大学	www.sicau.edu.cn
成都中医药大学	www.cdutcm.edu.cn
西南大学	www.swu.edu.cn
西南财经大学	www.swufe.edu.cn
贵州大学	www.gzu.edu.cn
西藏大学	www.utibet.edu.cn
西北大学	www.nwu.edu.cn
西安电子科技大学	www.xidian.edu.cn
长安大学	www.chd.edu.cn
陕西师范大学	www.snnu.edu.cn
青海大学	www.qhu.edu.cn
宁夏大学	www.nxu.edu.cn
石河子大学	www.shzu.edu.cn
中国石油大学（北京）	www.cup.edu.cn
中国石油大学（华东）	www.upc.edu.cn
宁波大学	www.nbu.edu.cn
第二军医大学	www.smmu.edu.cn
第四军医大学	www.fmmu.edu.cn
中国科学院大学	www.ucas.edu.cn
